w,w,w,w,w,w,w,w,w,w,w,w,w,w,w,w,w,w,w,w,w,x,w,w
w,,,,,,,,eh,,,,,,,w,,,,,,,,w
w,w,w,w,w,,w,,w,w,w,,w,w,w,w,w,w,,w,w,w,w,w
w,,,,w,,w,w,w,w,w,,w,w,w,w,w,w,,w,w,w,w,w
w,w,w,w,w,,w,w,w,w,w,,w,w,w,w,w,w,,w,w,w,w,w
w,p,,,,,,e,,,,,,,w,,,,,,e,,,w
w,w,w,w,w,,w,w,w,w,w,,w,w,w,w,w,w,ev,w,w,w,w,w
w,w,w,w,w,ev,w,w,w,w,w,ev,,w,w,w,w,,,w,w,w,w,w
w,w,w,w,w,,w,w,w,w,w,,w,w,,,eh,,w,w,w,w,w,w
w,,,,,,w,,eh,,,,,,,w,,,,,eh,,,w
w,w,w,w,w,w,w,w,w,w,w,w,w,w,w,w,w,w,w,w,w,w,w,w